##########
# #   #  #
# 6 g G# #
#   #    #
##########
